MWWWWMWWWMWWWWWWWWMWWWMWWWWMWd.      ..........'',,,lKMWWWWMWWWMWWWWMWWWMWWWWWWWWMWWWWMWWWMWWWWWWWWM
WWWWWWWMWWWWWWWWWWWWMWWWWWWWNl                      ,KWWWWWWWMWWWWMWWWMWWWWWWWWMWWWWWWWWMWWWWWWWWWWW
MWWWWWWWWMWWWWWWWWMWWWWWWWWMX:                      :XMWWWWMWWWWWWWWMWWWMWWWWMWWWMWWWWMWWWMWWWWWWWWM
WWWWWWWMWWWMWWWWMWWWMWWWWWWWK;                      oNWWWMWWWMWWWWMWWWMWWWMWWWWMWWWWWWWWMWWWMWWWWWWW
MWWWWWWWWMWWWWWWWWMWWWWWWWWM0'                     .dWWWWWWMWWWWWWWWWWWWWWWWWWWWWMWWWWMWWWMWWWWWWWWM
WWWWWWWWWWWWWWWWWWWWWWWWWWWWk.                     .xWWWWWWWWWWWWWWWWWWWWWWWWWWWWWWWWWWWWWWWWWWWWWWW
WWWWWWWWWWWWWWWWWWWWWWWWWWWWx.                     .kWWWWWWWWWWWWWWWWWWWWWWWWWWWWWWWWWWWWWWWWWWWWWWW
WWWWWWWWWWWWWWWWWWWWWWWWWWWWo                      .OWWWWWWWWWWWWWWWWWWWWWWWWWWWWWWWWWWWWWWWWWWWWWWW
WWWWWWWWWWWWWWWWWWWWWWWWWWWNl                      .OWWWWWWWWWWWWWWWWWWWWWWWWWWWWWWWWWWWWWWWWWWWWWWW
WWWWWWWWWWWWWWWWWWWWWWWWWWWX:                       :OXNNNWWWWWMWWWWWWWWWWWWWWWWWWWWWWWWWWWWWWWWWWWW
WWWWWWWMWWWMWWWWWWWWMWWWWWWK,                        ..''l0XWWWWWWWWWWWWWWWWWWWMWWWMWWWWWWWWMWWWWWWW
MWWWWWWWWMWWWMWWWWMWWWMWWWM0'                             .',:ododKWMWWWMWWWWWWWWMWWWMMWWWMWWWMWWWWM
WWWWWWWMWWWMWWWWMWWWMWWWWMWk.                                     ,odod0NNOk0XWWN0OOkxkxkKNWMWWWWWWW
MWWWWWWWWMWWWMWWWWMWWWWWWWWx.                                          .,,. ..;:,.       .:okKNNWWWW
WWWWWWWWWWWWWWWWWWWWMWWWWWNo                                                                 .':0WWW
WWWWWWWWWWWWWWWWWWWWWWWWWWNc                                                                   .xWWW
WWWWWWWWWWWWWWWWWWWWWWWWWWX;                                                                    oWWW
WWWWWWWWWWWWWWWWWWWWWWWWWW0'                                                                    lNWW
KKXXNWWWWWWWWWWWWWWWWWWWWWk.                                                                    cNWW
'..'',;:::clllodxxxkOOOO00l                                                                     ;XWW
O,                     ...                                                                      '0MM
WKl.                                                                                             lXW
MWNKl.                                                                                           .oN
WWWMNk;                                                                                           .d
WWWWWWXx:.                                                                                         .
WWWWWWWWWKo.                                                                                        
WWWWWWWWWWNd.                                                                                      .
WWWWWWWWWWWNl                                                                                      c
WWWWWWWWWWWWx.                                                                                     l
WWWWWWWWWWWW0,                                                                                    .x
WWWWWWWMWWWMW0:.           .:dOOxolc:,.                                                           ,0
MWWWWWWWWMWWWWNk:.        'kWWWWWWWWWNKo.                                                       .,xN
WWWWWWWMWWWMWWWWWKx:.    ,ONWMWWWMWWWWMW0l.                                                 .:dOXWWW
MWWWWWWWWMWWWMWWWWMNKxl:oKWMWWWMWWWWWWWWMWO;                                              ,dKWMWWWWM
WWWWWWWWWWWWWWWWWWWWMWWWWWWWWMWWWMWWWWWWWWW0,                                          .ckXWWWWWWMWW
WWWWWWWWWWWWWWWWWWWWWWWWWWWWWWWWWWWWWWWWWWWWk.                                      .,o0NWWWWWWWWWWW
WWWWWWWWWWWWWWWWWWWWWWWWWWWWWWWWWWWWWWWWWWWWNo.                                 .':d0NWWWWWWWWWWWWWW
WWWWWWWWWWWWWWWWWWWWWWWWWWWWWWWWWWWWWWWWWWWWWXl.                             .;d0XWWWWWWWWWWWWWWWWWW
WWWWWWWWWWWWWWWWWWWWWWWWWWWWWWWWWWWWWWWWWWWWWWNO;                         'cxKNWWWWWWWWWWWWWWWWWWWWW
WWWWWWWWWWWWWWWWWWWWWWWWWWWWWMWWWWWWWWWWWWWWWWWWXl'.                   .,lONWWWWWWWWWWWWWWWWWWWWWWWW
MWWWWWWWWMWWWMWWWWWWWWWWWWWMWWWMWWWWWWWWMWWWWMWWWNXkc.                .lOKNWWWWWWMWWWWMWWWMWWWMWWWWM
WWWWWWWMWWWWWWWWWWWWMWWWWWWWWMWWWMWWWWMWWWWWWWWMWWWWWo                .lKWWWWWWMWWWWWWWWMWWWWWWWWWWW
MWWWWWWWWMWWWWWWWWMWWWWWWWWMWWWMWWWWWWWWMWWWWWWWWMMWWx.               ;KWWWWWWWWWMWWWWWWWWMWWWWWWWWW
WWWWWWWMWWWMWWWWWWWWMWWWWWWWWMWWWMWWWWMWWWWWWWWMWWWWMK:              .xNWWWWWWWWWWWWWWWWMWWWMWWWWWWW
MWWWWWWWWMWWWWWWWWMWWWWWWWWWWWWWWWWWWWWWMWWWWMWWWWWWWWXc             .xXWWWWWWWWWMWWWWMWWWMWWWWWWWWM
WWWWWWWWWWWWWWWWWWWWWWWWWWWWWWWWWWWWWWWWWWWWWWWWWWWWWWW0,            .c0NWWWWWWWWWWWWWWWWWWWWWWWWWWW
WWWWWWWWWWWWWWWWWWWWWWWWWWWWWWWWWWWWWWWWWWWWWWWWWWWWWWWW0o:'.         ,kKWWWWWWWWWWWWWWWWWWWWWWWWWWW
WWWWWWWWWWWWWWWWWWWWWWWWWWWWWWWWWWWWWWWWWWWWWWWWWWWWWWWWWWWX0ko;...   .lKWWWWWWWWWWWWWWWWWWWWWWWWWWW
WWWWWWWWWWWWWWWWWWWWWWWWWWWWWWWWWWWWWWWWWWWWWWWWWWWWWWWWWWWWWWWNXKKOd:;xNWWWWWWWWWWWWWWWWWWWWWWWWWWW
MWWWMMWWWMWWWMMWWWMWWWMWWWWMWWWMWWWMMWWWMWWWMMWWWMMWWWMMWWWMWWWMMWWMMNXWMWWWMMWWWMWWWMMWWWMWWWMMWWWM
